30 Minutes of Torment=30minutesoftorment
Animated Kink=animatedkink
Bound Gangbangs=boundgangbangs
Bound Gods=boundgods
Bound In Public=boundinpublic
Butt Machine Boys=buttmachineboys
Device Bondage=devicebondage
Divine Bitches=divinebitches
Dungeon Sex=dungeonsex
Electro Sluts=electrosluts
Everything Butt=everythingbutt
Foot Worship=footworship
Fucking Machines=fuckingmachines
Hardcore Gangbang=hardcoregangbang
Hogtied=hogtied
Kink Test Shoots=kinktestshoots
Kink University=kinkuniversity
Men In Pain=meninpain
Men On Edge=menonedge
Naked Kombat=nakedkombat
Public Disgrace=publicdisgrace
Sadistic Rope=sadisticrope
Sex and Submission=sexandsubmission
The Training of O=thetrainingofo
The Upper Floor=theupperfloor
TS Pussy Hunters=tspussyhunters
TS Seduction=tsseduction
Ultimate Surrender=ultimatesurrender
Water Bondage=waterbondage
Whipped Ass=whippedass
Wired Pussy=wiredpussy